F 169, 169, 179
C 63, 48, 47
SO ./texture/snow1.xpm
WE ./texture/snow2.xpm
EA ./texture/snow3.xpm
NO ./texture/snow4.xpm

1111111111111111111111111
100100000000000000000000111
111111111011000001111110001
1000000000110000011101111111
11110111111111011 1 110000001
1111011111111101110101001111
1100000011010101110000001
1000000000000000110000001
1000000000000000110101001
11000001110101N11 11101111
1111011111101011011 110101
1111111111111111111111111