F 26, 103, 15
C 135,206,235
SO ./texture/sky.xpm
WE ./texture/sky.xpm
EA ./texture/sky.xpm
NO ./texture/sky.xpm

1111111111111111111111111
100100000000000000000000111
1111111110110000011111100001
1000000000110000011101111111
11110111111111011 1 110000001
1111011111111101110101001111
1100000011010101110000001
1000000000000000110000001
1000000000000000110101001
11000001110101011 11101111
1111N11111101011011 110101
1111111111111111111111111
